This user has 30 items in his/her history.
They are the following, grouped by rating:

"Dark Skies"	PG-13
"Cloverfield"	PG-13
"Code Name: The Cleaner"	PG-13
"I Got the Hook Up"	R
"Chef"	R
"Never Back Down 2: The Beatdown"	R
"August: Osage County"	R
"Once Upon a Time"	TV-14
"Moms at War"	TV-14
"Manu"	TV-14
"PILI Fantasy: War of Dragons"	TV-14
"Arjun: The Warrior Prince"	TV-14
"Chal Mere Bhai"	TV-14
"Eeda"	TV-14
"Siddhant"	TV-G
"The Blue Planet: A Natural History of the Oceans"	TV-G
"Revolutionary Love"	TV-MA
"The Silence of the Marsh"	TV-MA
"Hot Girls Wanted: Turned On"	TV-MA
"Iliza Shlesinger: Confirmed Kills"	TV-MA
"Boy Bye"	TV-MA
"#Selfie 69"	TV-MA
"Rise of the Zombie"	TV-MA
"Tales of the City (1993)"	TV-MA
"Love, Chunibyo & Other Delusions!"	TV-PG
"Humsafar"	TV-PG
"Samarppanam"	TV-PG
"True: Terrific Tales"	TV-Y
"Angelina Ballerina"	TV-Y
"Guru Aur Bhole"	TV-Y7
